30 30 24 22
 _ _ _ _ _ _ _ _ _ _ _ _ _ _ _ _ _ _ _ _ _ _ _ _ _ _ _ _ _ _ 
| |  _ _ _|_|_ _|  _ _|  _  |   | |_ _   _|_  |   |  _| |_  |
|  _ _ _ _   _|  _ _ _|_| |   |_ _   _|  _|_  | |  _ _ _ _  |
|_    | |    _ _     _|  _  |_|  _ _ _ _|   |_|_| | |  _ _ _|
| | | | |_|  _ _| |_ _|_|_  | |  _|    _  |_| |  _| |_  |_| |
| | | |_ _ _  |_ _    |_  | |  _ _  |_|_ _| | | |  _|    _|_|
|_ _| |  _|     |_ _| |  _| |_   _|  _    |     | |  _ _ _  |
|  _  | |  _|_|_  |_|   |   | | |_ _| | |_| |  _| |_  |  _  |
| | | | | |   | |_|   |  _|_|_  | |_|  _   _| |_ _ _ _ _| | |
| | | |_ _ _|_    | | |_ _|  _ _ _  |_|_  |     |_  |  _| |_|
|_ _|  _|     | |_| |_|  _| |_    |_  |_ _|  _|  _ _     _|_|
|  _  |_ _|_| |   |  _   _ _  |_| |  _  |_   _| |_ _  |_ _ _|
| |_  | |_ _   _| | |_   _ _|_ _ _| | |  _|  _|_ _ _| |     |
|_ _|_ _ _|_ _|  _ _  |_| |  _  | | | |  _ _|  _ _     _| |_|
|_ _   _ _ _   _| |_ _   _| |_  |_ _|  _|   |_    |_|_|   |_|
|  _| |    _ _|    _| |_ _ _  |_|  _    | | |  _  |_  | | | |
|  _ _  |_| |  _|_|_|_ _|_ _ _  |_| | |  _| |   |_  | | |  _|
|_|  _ _   _  |  _|  _ _ _    |_  |_|_|   |_  |_|_ _|_|_| | |
|_|_  | |_| | |    _|_|_  | |_| | | |  _ _|_   _  |  _ _  | |
| | | |  _ _ _ _| | |  _  | |     |_  |_ _  |_ _| | | |   | |
|_   _|  _  |   |_|  _|_  |_|_|_|  _ _ _| | |    _| |  _|_| |
| | | |  _|   |  _ _   _|_|  _ _ _    | | |  _  |_  |_  | |_|
|  _ _ _| | | |_|  _| |_   _  |_|_ _|   | |_  |   | |  _  |_|
|   | |   | |_  | |_   _|_  |_ _|  _| |_  | |_|_ _| |_  |_  |
|_|_  | |_|  _|    _|_ _    |_    |_ _| |_|  _   _   _| |_  |
|_ _ _| |  _|  _|_ _|   |_|    _| |    _|_ _  | | |_|   |  _|
|   |     |_ _  |  _|_ _|_|_|_  |_ _|_ _     _|_   _  | |  _|
| |_| |_|     |_   _| |_ _ _  | | |    _| |_|_ _ _|_|   |_  |
| |_  | | |_| |    _ _ _   _ _|  _  |_    |  _   _  |_|_  | |
|  _ _| | | | |_  |_   _|_ _ _    |   |_| | | |_|  _  |  _| |
|_ _ _|_|_ _|_ _|_ _ _ _|_ _|_ _|_|_|_|_|_|_ _|_ _|_|_ _|_ _|

1 1 1 1 1 1 1 1 1 1 1 1 1 1 1 1 1 1 1 1 1 1 1 1 1 1 1 1 1 1 
0 0 1 1 1 1 1 1 0 1 1 0 1 0 0 0 0 1 1 0 1 1 0 0 0 0 1 0 1 0 
0 1 1 1 1 0 1 0 1 1 1 1 0 0 0 1 1 0 1 0 1 1 0 0 0 1 1 1 1 0 
1 0 0 0 0 0 1 1 0 0 1 0 1 0 1 0 1 1 1 1 0 0 1 1 0 0 0 1 1 1 
0 0 0 0 1 0 1 1 0 1 1 1 1 0 0 0 1 0 0 1 0 1 0 0 1 0 1 0 1 0 
0 0 0 1 1 1 0 1 1 0 0 1 0 0 0 1 1 0 1 1 1 0 0 0 0 1 0 0 1 1 
1 1 0 0 1 0 0 0 1 1 0 0 1 0 1 0 1 0 1 0 0 0 0 0 0 0 1 1 1 0 
0 1 0 0 0 1 1 1 0 1 0 0 0 0 0 0 1 1 0 0 1 0 0 1 0 1 0 0 1 0 
0 0 0 0 0 0 0 0 1 0 0 0 1 1 1 0 0 1 0 1 0 1 0 1 1 1 1 1 0 0 
0 0 0 1 1 1 1 0 0 0 0 1 1 0 1 1 1 0 1 1 0 0 0 0 1 0 0 1 0 1 
1 1 0 1 0 0 0 0 1 0 1 0 1 0 1 0 0 1 0 1 1 0 1 0 1 1 0 0 1 1 
0 1 0 1 1 1 0 0 0 0 1 0 1 1 0 1 0 0 1 0 1 0 1 0 1 1 0 1 1 1 
0 1 0 0 1 1 0 1 0 0 1 0 1 1 1 1 1 0 0 0 1 0 1 1 1 1 0 0 0 0 
1 1 1 1 1 1 1 0 1 1 0 1 0 0 1 0 0 0 0 0 1 1 0 1 1 0 0 1 0 1 
1 1 0 1 1 1 0 1 0 1 1 0 1 0 1 0 1 1 0 1 0 0 1 0 0 1 1 0 0 1 
0 1 0 0 0 1 1 0 0 1 0 1 1 1 0 1 0 1 0 0 0 0 0 1 0 1 0 0 0 0 
0 1 1 0 1 0 0 1 1 1 1 1 1 1 1 0 1 0 0 0 1 0 0 0 1 0 0 0 0 1 
1 0 1 1 0 1 0 0 1 0 1 1 1 0 0 1 0 1 1 0 0 1 0 1 1 1 1 1 0 0 
1 1 0 0 1 0 0 0 0 1 1 1 0 0 1 0 0 0 0 1 1 1 0 1 0 0 1 1 0 0 
0 0 0 0 1 1 1 1 0 0 0 1 0 0 0 0 0 1 0 1 1 0 1 1 0 0 0 0 0 0 
1 0 1 0 1 0 0 0 1 0 1 1 0 1 1 1 0 1 1 1 0 0 0 0 1 0 0 1 1 0 
0 0 0 0 1 0 0 0 1 1 0 1 1 0 1 1 1 0 0 0 0 0 1 0 1 0 1 0 0 1 
0 1 1 1 0 0 0 1 0 1 0 1 0 1 0 1 1 1 0 0 0 1 0 0 0 0 0 1 0 1 
0 0 0 0 0 0 1 0 0 1 0 1 1 0 1 1 0 1 0 1 0 0 1 1 1 0 1 0 1 0 
1 1 0 0 1 0 1 0 0 1 1 1 0 0 1 0 0 1 1 0 1 0 1 0 1 0 1 0 1 0 
1 1 1 0 0 1 0 1 1 1 0 0 1 0 0 1 0 0 0 1 1 1 0 0 0 1 0 0 0 1 
0 0 0 0 0 1 1 0 0 1 1 1 1 1 1 0 1 1 1 1 0 0 1 1 0 1 0 0 0 1 
0 1 0 1 0 0 0 1 0 1 0 1 1 1 0 0 0 0 0 1 0 1 1 1 1 1 0 0 1 0 
0 1 0 0 0 1 0 0 0 1 1 1 0 1 1 0 1 0 1 0 0 0 1 0 1 0 1 1 0 0 
0 1 1 0 0 0 0 1 0 1 0 1 1 1 1 0 0 0 0 1 0 0 0 1 0 1 0 0 1 0 
1 1 1 1 1 1 1 1 1 1 1 1 1 1 1 1 1 1 1 1 1 1 1 1 1 1 1 1 1 1 
1 1 0 0 0 1 1 0 1 0 0 1 0 0 1 0 1 1 0 0 0 1 0 1 0 1 0 1 1 0 1 
1 0 0 0 0 0 0 1 0 0 0 1 1 1 0 1 0 0 0 1 0 1 0 1 1 0 0 0 0 0 1 
1 0 0 1 1 0 0 0 0 0 0 1 0 0 1 1 0 0 0 0 1 0 1 1 1 1 1 0 0 0 1 
1 1 1 1 1 1 0 0 1 1 0 1 1 0 1 1 0 1 0 0 0 1 1 1 0 1 1 0 1 1 1 
1 1 1 1 0 0 0 1 0 0 0 1 0 1 1 0 0 0 1 1 0 1 1 1 1 0 1 0 0 1 1 
1 0 1 1 0 1 0 0 1 0 1 1 0 1 1 0 0 1 0 0 0 1 0 0 1 1 0 0 0 0 1 
1 0 0 1 1 0 1 1 0 1 1 0 1 0 1 1 1 0 1 1 1 1 1 0 1 1 0 1 0 0 1 
1 1 1 1 1 1 0 1 1 1 0 1 0 1 1 0 1 1 1 0 0 0 1 1 0 0 0 0 1 1 1 
1 1 1 1 0 0 1 0 0 1 1 1 0 1 0 0 0 0 1 1 0 1 0 0 1 0 1 0 1 1 1 
1 0 1 0 1 0 0 1 1 1 1 1 0 1 1 0 0 1 0 1 0 1 0 1 0 0 0 0 0 1 1 
1 0 0 1 0 1 1 1 0 1 0 0 0 0 0 1 1 1 0 0 1 0 0 1 1 0 0 1 0 0 1 
1 1 0 1 1 0 0 0 1 1 1 0 0 0 1 0 0 1 1 1 0 1 0 1 0 0 1 1 0 0 1 
1 0 1 0 0 1 0 1 0 0 0 1 1 1 0 0 1 1 1 1 0 0 1 0 0 0 0 0 1 1 1 
1 0 0 0 0 0 0 0 1 1 0 0 0 1 1 0 1 0 1 0 1 0 1 0 0 1 1 1 0 1 1 
1 0 1 1 0 0 0 1 0 0 1 1 0 0 0 1 1 0 0 0 1 1 1 0 0 1 0 1 1 1 1 
1 0 0 0 1 1 1 0 1 1 1 0 1 0 0 0 1 1 1 1 0 1 1 0 1 0 1 1 1 0 1 
1 1 0 0 0 0 0 1 0 1 0 0 0 0 0 1 0 1 1 1 0 1 0 1 1 0 1 1 1 1 1 
1 1 0 1 1 1 1 1 0 0 1 1 0 1 1 1 1 1 1 0 0 1 0 0 0 1 0 0 0 1 1 
1 1 1 1 0 0 0 0 1 1 1 0 0 1 1 0 0 1 0 1 0 0 1 0 1 1 1 1 0 1 1 
1 0 0 1 0 0 1 0 1 1 0 1 0 1 1 1 1 0 0 0 1 1 1 0 0 1 1 0 1 1 1 
1 1 1 1 0 1 0 1 0 0 0 0 1 1 0 0 0 0 0 1 1 1 0 0 1 0 1 0 1 1 1 
1 0 0 0 1 1 1 1 1 0 1 1 0 0 0 1 1 0 1 0 1 1 0 1 0 1 1 0 0 1 1 
1 0 1 1 0 1 1 0 1 1 0 0 1 0 1 0 1 0 1 1 0 1 1 1 0 1 1 0 1 0 1 
1 1 0 1 1 1 0 1 0 0 1 0 0 0 1 0 0 1 0 1 1 1 0 0 0 0 0 1 1 0 1 
1 0 0 1 1 0 1 0 1 0 1 0 1 1 0 0 1 1 0 0 1 0 0 1 1 1 1 0 1 0 1 
1 0 1 0 0 1 0 0 1 0 1 0 1 1 1 0 1 0 1 0 0 0 0 1 0 0 0 1 1 0 1 
1 1 1 1 1 0 0 1 0 0 1 1 0 0 0 1 1 1 0 0 1 1 1 0 0 1 1 0 1 0 1 
1 1 0 1 1 1 1 1 0 0 0 0 0 0 0 1 0 0 1 0 0 1 0 0 0 0 1 1 0 1 1 
1 0 0 1 1 1 1 1 0 1 0 0 1 0 0 0 0 1 0 1 1 1 1 1 1 0 0 1 0 1 1 
1 0 0 1 1 0 1 0 1 0 0 0 1 0 1 0 1 1 1 1 1 1 0 1 0 1 1 0 1 0 1 
