9 9 6 4
 _ _ _ _ _ _ _ _ _ 
|_    | |   |   | |
|  _|_ _  |_ _|_ _|
|  _ _|_ _   _|   |
| |_   _ _  |   |_|
|_  |_ _|  _ _ _ _|
|    _|   |_ _   _|
| |      _ _  | | |
|_|_|_|  _|     |_|
|_ _|_ _ _ _|_ _ _|

1 1 1 1 1 1 1 1 1 
1 0 0 0 0 0 0 0 0 
0 1 1 1 0 1 1 1 1 
0 1 1 1 1 0 1 0 0 
0 1 0 1 1 0 0 0 1 
1 0 1 1 0 1 1 1 1 
0 0 1 0 0 1 1 0 1 
0 0 0 0 1 1 0 0 0 
1 1 1 0 1 0 0 0 1 
1 1 1 1 1 1 1 1 1 
1 0 0 1 1 0 1 0 1 1 
1 0 1 0 0 1 0 1 0 1 
1 0 0 1 0 0 0 1 0 1 
1 1 0 0 0 0 1 0 1 1 
1 0 1 0 1 0 0 0 0 1 
1 0 0 1 0 1 0 0 0 1 
1 1 0 0 0 0 0 1 1 1 
1 1 1 1 0 1 0 0 1 1 
1 0 1 0 0 0 1 0 0 1 
